{
  "map_id": 1002,
  "name": "青竹山",
  "map_type": 2,
  "width": 800,
  "height": 800,
  "region_size": 50,
  "tile_width": 10,
  "tile_height": 10,
  "is_instance": false,
  "max_players": 300,
  "description": "东胜州的野外地图，竹林茂密，盛产竹笋和灵竹",
  "background": "qing_zhu_mountain_bg.jpg",
  "music": "qing_zhu_mountain.mp3",
  "weather_type": "sunny",
  "min_level": 5,
  "max_level": 15,
  "respawn_rate": 1.2,
  "tile_map": [
    [0, 0, 0, 0, 0, 0, 0, 0, 0, 0, 0, 0, 0, 0, 0, 0, 0, 0, 0, 0, 0, 0, 0, 0, 0, 0, 0, 0, 0, 0],
    [0, 1, 1, 1, 1, 1, 1, 1, 1, 1, 1, 1, 1, 1, 1, 1, 1, 1, 1, 1, 1, 1, 1, 1, 1, 1, 1, 1, 1, 0],
    [0, 1, 1, 2, 2, 2, 1, 1, 1, 1, 1, 1, 1, 1, 1, 1, 1, 1, 1, 1, 1, 1, 1, 1, 1, 1, 2, 2, 1, 0],
    [0, 1, 1, 2, 3, 2, 1, 1, 1, 1, 1, 1, 1, 1, 1, 1, 1, 1, 1, 1, 1, 1, 1, 1, 1, 1, 2, 3, 1, 0],
    [0, 1, 1, 1, 2, 1, 1, 1, 1, 1, 1, 1, 1, 1, 1, 1, 1, 1, 1, 1, 1, 1, 1, 1, 1, 1, 1, 2, 1, 0],
    [0, 1, 1, 1, 1, 1, 1, 1, 1, 1, 1, 1, 1, 1, 1, 1, 1, 1, 1, 1, 1, 1, 1, 1, 1, 1, 1, 1, 1, 0],
    [0, 1, 1, 1, 1, 1, 1, 1, 1, 1, 1, 1, 1, 1, 1, 1, 1, 1, 1, 1, 1, 1, 1, 1, 1, 1, 1, 1, 1, 0],
    [0, 1, 1, 1, 1, 1, 1, 1, 1, 1, 1, 1, 1, 1, 1, 1, 1, 1, 1, 1, 1, 1, 1, 1, 1, 1, 1, 1, 1, 0],
    [0, 1, 1, 1, 1, 1, 1, 1, 1, 1, 1, 1, 1, 1, 1, 1, 1, 1, 1, 1, 1, 1, 1, 1, 1, 1, 1, 1, 1, 0],
    [0, 1, 1, 1, 1, 1, 1, 1, 1, 1, 1, 1, 1, 1, 1, 1, 1, 1, 1, 1, 1, 1, 1, 1, 1, 1, 1, 1, 1, 0],
    [0, 1, 1, 1, 1, 1, 1, 1, 1, 1, 1, 1, 1, 1, 1, 1, 1, 1, 1, 1, 1, 1, 1, 1, 1, 1, 1, 1, 1, 0],
    [0, 1, 1, 1, 1, 1, 1, 1, 1, 1, 1, 1, 1, 1, 1, 1, 1, 1, 1, 1, 1, 1, 1, 1, 1, 1, 1, 1, 1, 0],
    [0, 1, 1, 1, 1, 1, 1, 1, 1, 1, 1, 1, 1, 1, 1, 1, 1, 1, 1, 1, 1, 1, 1, 1, 1, 1, 1, 1, 1, 0],
    [0, 1, 1, 1, 1, 1, 1, 1, 1, 1, 1, 1, 1, 1, 1, 1, 1, 1, 1, 1, 1, 1, 1, 1, 1, 1, 1, 1, 1, 0],
    [0, 1, 1, 1, 1, 1, 1, 1, 1, 1, 1, 1, 1, 1, 1, 1, 1, 1, 1, 1, 1, 1, 1, 1, 1, 1, 1, 1, 1, 0],
    [0, 1, 1, 1, 1, 1, 1, 1, 1, 1, 1, 1, 1, 1, 1, 1, 1, 1, 1, 1, 1, 1, 1, 1, 1, 1, 1, 1, 1, 0],
    [0, 1, 1, 1, 1, 1, 1, 1, 1, 1, 1, 1, 1, 1, 1, 1, 1, 1, 1, 1, 1, 1, 1, 1, 1, 1, 1, 1, 1, 0],
    [0, 1, 1, 1, 1, 1, 1, 1, 1, 1, 1, 1, 1, 1, 1, 1, 1, 1, 1, 1, 1, 1, 1, 1, 1, 1, 1, 1, 1, 0],
    [0, 1, 1, 1, 1, 1, 1, 1, 1, 1, 1, 1, 1, 1, 1, 1, 1, 1, 1, 1, 1, 1, 1, 1, 1, 1, 1, 1, 1, 0],
    [0, 1, 1, 1, 1, 1, 1, 1, 1, 1, 1, 1, 1, 1, 1, 1, 1, 1, 1, 1, 1, 1, 1, 1, 1, 1, 1, 1, 1, 0],
    [0, 1, 1, 1, 1, 1, 1, 1, 1, 1, 1, 1, 1, 1, 1, 1, 1, 1, 1, 1, 1, 1, 1, 1, 1, 1, 1, 1, 1, 0],
    [0, 1, 1, 1, 1, 1, 1, 1, 1, 1, 1, 1, 1, 1, 1, 1, 1, 1, 1, 1, 1, 1, 1, 1, 1, 1, 1, 1, 1, 0],
    [0, 1, 1, 1, 1, 1, 1, 1, 1, 1, 1, 1, 1, 1, 1, 1, 1, 1, 1, 1, 1, 1, 1, 1, 1, 1, 1, 1, 1, 0],
    [0, 1, 1, 1, 1, 1, 1, 1, 1, 1, 1, 1, 1, 1, 1, 1, 1, 1, 1, 1, 1, 1, 1, 1, 1, 1, 1, 1, 1, 0],
    [0, 1, 1, 1, 1, 1, 1, 1, 1, 1, 1, 1, 1, 1, 1, 1, 1, 1, 1, 1, 1, 1, 1, 1, 1, 1, 1, 1, 1, 0],
    [0, 1, 1, 1, 1, 1, 1, 1, 1, 1, 1, 1, 1, 1, 1, 1, 1, 1, 1, 1, 1, 1, 1, 1, 1, 1, 1, 1, 1, 0],
    [0, 1, 1, 1, 1, 1, 1, 1, 1, 1, 1, 1, 1, 1, 1, 1, 1, 1, 1, 1, 1, 1, 1, 1, 1, 1, 1, 1, 1, 0],
    [0, 1, 1, 2, 2, 1, 1, 1, 1, 1, 1, 1, 1, 1, 1, 1, 1, 1, 1, 1, 1, 1, 1, 1, 1, 1, 2, 2, 1, 0],
    [0, 1, 1, 1, 1, 1, 1, 1, 1, 1, 1, 1, 1, 1, 1, 1, 1, 1, 1, 1, 1, 1, 1, 1, 1, 1, 1, 1, 1, 0],
    [0, 0, 0, 0, 0, 0, 0, 0, 0, 0, 0, 0, 0, 0, 0, 0, 0, 0, 0, 0, 0, 0, 0, 0, 0, 0, 0, 0, 0, 0]
  ],
  "spawn_points": [
    {
      "type": "monster",
      "id": 2001,
      "x": 100,
      "y": 100,
      "z": 0,
      "name": "竹叶青蛇"
    },
    {
      "type": "monster",
      "id": 2002,
      "x": 700,
      "y": 100,
      "z": 0,
      "name": "竹鼠"
    },
    {
      "type": "monster",
      "id": 2003,
      "x": 100,
      "y": 700,
      "z": 0,
      "name": "青竹精"
    },
    {
      "type": "monster",
      "id": 2004,
      "x": 700,
      "y": 700,
      "z": 0,
      "name": "竹笋怪"
    }
  ],
  "teleport_points": [
    {
      "id": 1003,
      "map_id": 1002,
      "x": 50,
      "y": 250,
      "z": 0,
      "target_map_id": 1001,
      "target_x": 450,
      "target_y": 250,
      "target_z": 0,
      "name": "返回青竹村",
      "required_level": 0,
      "required_item": 0,
      "is_active": true
    },
    {
      "id": 1004,
      "map_id": 1002,
      "x": 750,
      "y": 250,
      "z": 0,
      "target_map_id": 1003,
      "target_x": 50,
      "target_y": 250,
      "target_z": 0,
      "name": "前往东海之滨",
      "required_level": 10,
      "required_item": 0,
      "is_active": true
    }
  ],
  "buildings": [],
  "resources": [
    {
      "resource_id": 2001,
      "map_id": 1002,
      "type": "herb",
      "x": 200,
      "y": 200,
      "z": 0,
      "respawn_time": 60,
      "item_id": 1003,
      "quantity": 1,
      "level": 5,
      "is_gathering": false
    },
    {
      "resource_id": 2002,
      "map_id": 1002,
      "type": "herb",
      "x": 600,
      "y": 200,
      "z": 0,
      "respawn_time": 60,
      "item_id": 1003,
      "quantity": 1,
      "level": 5,
      "is_gathering": false
    },
    {
      "resource_id": 2003,
      "map_id": 1002,
      "type": "wood",
      "x": 200,
      "y": 600,
      "z": 0,
      "respawn_time": 120,
      "item_id": 1004,
      "quantity": 1,
      "level": 5,
      "is_gathering": false
    },
    {
      "resource_id": 2004,
      "map_id": 1002,
      "type": "wood",
      "x": 600,
      "y": 600,
      "z": 0,
      "respawn_time": 120,
      "item_id": 1004,
      "quantity": 1,
      "level": 5,
      "is_gathering": false
    }
  ]
}